徹夜する|てつやする|to work all night  |  |  |  |
引退する|いんたいする| to retire, to give up one's position |  |  |  |
安定する|あんていする|to be steady, to be stable|  |  |  |
進歩する|しんぽする|to make progress, to advance  |  |  |  |
自立する|じりつする|to become independent  |  |  |  |
翻訳する|ほにゃくする| to translate |  |  |  |
世話する|せわする|to take care of, to look after (someone)  |  |  |  |
存在する|そんざいする|to exist  |  |  |  |
調整する|ちょうせいする|to regulate, to adjust|  |  |  |
後悔する|こうかいする|to regret, to repent, to be sorry  |  |  |  |
刺激する|しげきする|to stimulate, to irritate, to excite  |  |  |  |
反対する|はんたいする| to be against, to be opposed |  |  |  |
観察する|かんさつする|to observe, to watch closely  |  |  |  |
合計する|ごうけいする|to add up, to total|  |  |  |
ちゅうちょする|ちゅうちょする|to hesitate, to waver|  |  |  |
安心する|あんしんする|to be relieved, to feel secure|  |  |  |
加工する|かこうする|to process, to manufacture  |  |  |  |
専攻する|せんこうする|to specialize, to major in  |  |  |  |
指摘する|してきする|to point out  |  |  |  |
パスする|パスする|to pass (mainly used in sports)  |  |  |  | PAGE 346
回復する|かいふくする|to restore, to recuperate  |  |  |  |
仮定する|かていする|to assume, to suppose  |  |  |  |
成功する|せいこうする|to succeed  |  |  |  |
発明する|はつめいする| to invent |  |  |  |
ドラッグする|ドラッグする|to drag with a (computer) mouse|  |  |  |
食事する|しょくじする|to take a meal  |  |  |  |
取引する|とりひきする|to have dealings with  |  |  |  |
ジョギングする|ジョギングする|to jog  |  |  |  |
分析する|ぶんせきする|to analyze, to break down|  |  |  |
記念する|きねんする|to commemorate  |  |  |  |
料理する|りょうりする|to cook  |  |  |  |
我慢する|がまんする|to be patient, to endure|  |  |  |
増加する|ぞうかする|to increase, to grow, to augment  |  |  |  |
ダンスする|ダンスする|to dance|  |  |  |
繫栄する|はんえいする| to prosper, to flourish |  |  |  |
訪問する|ほうもんする| to visit, to call on, to pay a visit |  |  |  |
結婚する|けっこんする|to marry  |  |  |  |
予想する|よそうする|to predict, to anticipate  |  |  |  |
判断する|はんだんする| to judge, to conclude |  |  |  |
招待する|しょうたいする|to invite  |  |  |  |
操作する|そうさする|to operate, to handle  |  |  |  |
到着する|とうちゃくする|to arrive  |  |  |  |
昇進する|しょうしんする|to be promoted  |  |  |  |
契約する|けいやくする|to contract, to make a contract with  |  |  |  |
ミックスする|ミックスする|to mix  |  |  |  |
開催する|かいさいする|to hold (an event)  |  |  |  |
黙認する|もくにんする|to permit or approve tacitly  |  |  |  |
計画する|けいかくする|to plan  |  |  |  |
拡大する|かくだいする|to magnify, to enlarge, to expand  |  |  |  |
延期する|えんきする|to postpone, to put off|  |  |  |
関係する|かんけいする|to be related, to have a relationship  |  |  |  |
