把 (bǎ) - The "ba" construction (used to shift the object to before the verb) |  | - HSK Level 2
被 (bèi) - Passive marker |  | - HSK Level 2
一下 (yīxià) - A short or quick action; momentarily |  | - HSK Level 2
再说 (zàishuō) - Moreover, furthermore |  | - HSK Level 2
最 (zuì) - Most, -est (superlative marker) |  | - HSK Level 2
比如 (bǐrú) - For example |  | - HSK Level 2
可是 (kěshì) - But, however |  | - HSK Level 2
已经 (yǐjīng) - Already |  | - HSK Level 2
还 (hái) - Still, yet; in addition |  | - HSK Level 2
才 (cái) - Only just, not until |  | - HSK Level 2
就 (jiù) - Then, precisely, just |  | - HSK Level 2
一直 (yīzhí) - Continuously, all along |  | - HSK Level 2
一般 (yībān) - Generally, normally |  | - HSK Level 2
真的 (zhēnde) - Really, truly |  | - HSK Level 2
可能 (kěnéng) - Maybe, possibly |  | - HSK Level 2
一起 (yīqǐ) - Together (indicating joint action) |  | - HSK Level 2
根据 (gēnjù) - According to, based on |  | - HSK Level 2
除非 (chúfēi) - Unless |  | - HSK Level 2
以前 (yǐqián) - Before, previously |  | - HSK Level 2
之后 (zhīhòu) - Afterward, after |  | - HSK Level 2
刚刚 (gānggāng) - Just now/recently |  | - HSK Level 2
虽然…但是… (suīrán… dànshì…) - Although… but… |  | - HSK Level 2
不仅…还… (bùjǐn… hái…) - Not only... but also... |  | - HSK Level 2
既…又… (jì… yòu…) - Both... and... |  | - HSK Level 2
越…越… (yuè… yuè…) - The more... the more... |  | - HSK Level 2
不但…而且… (bùdàn… érqiě…) - Not only... but also... |  | - HSK Level 2
或者 (huòzhě) - Or (in statements) |  | - HSK Level 2
当…时候 (dāng… shíhòu) - When... |  | - HSK Level 2
只有…才… (zhǐyǒu… cái…) - Only if/when... then... |  | - HSK Level 2
为了 (wèile) - In order to, for the purpose of |  | - HSK Level 2
如果…的话 (rúguǒ… de huà) - If... |  | - HSK Level 2
因为…所以… (yīnwèi… suǒyǐ…) - Because... so... |  | - HSK Level 2
要是…就… (yàoshi… jiù…) - If... then... |  | - HSK Level 2
突然 (tūrán) - Suddenly |  | - HSK Level 2
又 (yòu) - Again (referring to a past action) |  | - HSK Level 2
总是 (zǒngshì) - Always |  | - HSK Level 2
曾经 (céngjīng) - Once, in the past |  | - HSK Level 2
开始 (kāishǐ) - Start, begin |  | - HSK Level 2
虽然 (suīrán) - Although |  | - HSK Level 2
要么…要么… (yàome... yàome...) - Either... or... |  | - HSK Level 2
还没 (hái méi) - Still not/haven't yet |  | - HSK Level 2
有点儿 (yǒudiǎnr) - A little/bit |  | - HSK Level 2
别 (bié) - Don't (imperative negative command) |  | - HSK Level 2
先...然后 (xiān... ránhòu) - First...then... |  | - HSK Level 2
只 (zhǐ) - Only (limiting quantity) |  | - HSK Level 2
比如说 (bǐrú shuō) - For instance, such as |  | - HSK Level 2
还是 (háishi) - Had better, it's better to |  | - HSK Level 2
等 (děng) - Wait; and so on, etc. |  | - HSK Level 2
着 (zhe) - Particle indicating an ongoing action |  | - HSK Level 2
的时候 (de shíhòu) - When (referring to a specific time) |  | - HSK Level 2
一边...一边... (yìbiān... yìbiān...) - Do two things at the same time |  | - HSK Level 2
的话 (de huà) - Used at the end of a conditional clause |  | - HSK Level 2
再 (zài) - Again; then (in future actions) |  | - HSK Level 2
最后 (zuìhòu) - At last, finally |  | - HSK Level 2
除了...都 (chúle... dōu) - Except for..., all... |  | - HSK Level 2
对 (duì) - Correct, right; towards |  | - HSK Level 2
可能 (kěnéng) - Maybe, possible |  | - HSK Level 2
从来 (cónglái) - Always; at all times, never (when used with 不 or 没) |  | - HSK Level 2
向 (xiàng) - Towards; direction |  | - HSK Level 2
每 (měi) - Every; each |  | - HSK Level 2
一样 (yíyàng) - The same as |  | - HSK Level 2
过 (guò) - Indicates a past experience |  | - HSK Level 2
后来 (hòulái) - Later on, afterwards |  | - HSK Level 2
突然 (tūrán) - Suddenly, unexpectedly |  | - HSK Level 2
对了 (duìle) - By the way; oh right |  | - HSK Level 2
最近 (zuìjìn) - Recently |  | - HSK Level 2
已经 (yǐjīng) - Already |  | - HSK Level 2
一直 (yīzhí) - Continuously, always, all the way |  | - HSK Level 2
除了...以外 (chúle...yǐwài) - Apart from.../Except for... |  | - HSK Level 2
所以 (suǒyǐ) - So, therefore |  | - HSK Level 2
为了 (wèile) - For, in order to, for the sake of |  | - HSK Level 2
虽然 (suīrán) - Although, though |  | - HSK Level 2
如果 (rúguǒ) - If, in case, in the event that |  | - HSK Level 2
只要 (zhǐyào) - As long as, only if |  | - HSK Level 2
但是 (dànshì) - But, however |  | - HSK Level 2
不但...而且 (bùdàn... érqiě) - Not only... but also... |  | - HSK Level 2
不过 (búguò) - However, but |  | - HSK Level 2
因为 (yīnwèi) - Because, owing to, on account of |  | - HSK Level 2
或者 (huòzhě) - Or (used in a statement) |  | - HSK Level 2
不仅...还... (bùjǐn... hái...) - Not only... but also... |  | - HSK Level 2
并且 (bìngqiě) - And, moreover, furthermore |  | - HSK Level 2
越来越 (yuè lái yuè) - More and more |  | - HSK Level 2
虽然...但是... (suīrán... dànshì...) - Although...but... |  | - HSK Level 2
先...再... (xiān... zài...) - First...then... |  | - HSK Level 2
也许 (yěxǔ) - Perhaps, maybe |  | - HSK Level 2
还好 (hái hǎo) - Fortunately, luckily |  | - HSK Level 2
一共 (yígòng) - In total, altogether |  | - HSK Level 2
根据 (gēnjù) - According to, based on |  | - HSK Level 2
甚至 (shènzhì) - Even (to the extent that) |  | - HSK Level 2
到底 (dàodǐ) - What on earth; what in the world (used in a question for emphasis) |  | - HSK Level 2
由于 (yóuyú) - Due to, because of |  | - HSK Level 2
只有...才... (zhǐyǒu... cái...) - Only if/when... then... |  | - HSK Level 2
否则 (fǒuzé) - Otherwise, or else |  | - HSK Level 2
而 (ér) - And, but, yet |  | - HSK Level 2
随便 (suíbiàn) - Casual, careless; as one wishes |  | - HSK Level 2
即使 (jíshǐ) - Even if, even though |  | - HSK Level 2
当然 (dāngrán) - Of course, certainly |  | - HSK Level 2
忽然 (hūrán) - Suddenly, all of a sudden |  | - HSK Level 2
其实 (qíshí) - Actually, in fact |  | - HSK Level 2
幸好 (xìnghǎo) - Fortunately, luckily |  | - HSK Level 2