的 (de) - Possessive/Descriptive particle  |  | - HSK Level 1
是 (shì) - Is/Are |  | - HSK Level 1
吗 (ma) - Question particle for yes/no questions |  | - HSK Level 1
不 (bù) - Negation word for actions/states |  | - HSK Level 1
在 (zài) - At/In/On (location or action ongoing) |  | - HSK Level 1
了 (le) - Completed action marker |  | - HSK Level 1
和 (hé) - And (connecting nouns) |  | - HSK Level 1
有 (yǒu) - Have/Has |  | - HSK Level 1
要 (yào) - Want to/Need to |  | - HSK Level 1
也 (yě) - Also/Too |  | - HSK Level 1
很 (hěn) - Very (used before adjectives) |  | - HSK Level 1
可以 (kěyǐ) - Can/May (permission) |  | - HSK Level 1
去 (qù) - Go |  | - HSK Level 1
来 (lái) - Come |  | - HSK Level 1
人 (rén) - Person/People |  | - HSK Level 1
个 (gè) - General measure word |  | - HSK Level 1
多少 (duōshǎo) - How much/How many |  | - HSK Level 1
哪 (nǎ) - Which |  | - HSK Level 1
这 (zhè) - This |  | - HSK Level 1
那 (nà) - That |  | - HSK Level 1
什么 (shénme) - What |  | - HSK Level 1
谁 (shéi) - Who |  | - HSK Level 1
哪儿 (nǎr) - Where |  | - HSK Level 1
为什么 (wèishénme) - Why |  | - HSK Level 1
怎么 (zěnme) - How |  | - HSK Level 1
不是 (bù shì) - Is not/Are not |  | - HSK Level 1
喜欢 (xǐhuān) - Like |  | - HSK Level 1
看 (kàn) - Look/See/Watch |  | - HSK Level 1
听 (tīng) - Listen |  | - HSK Level 1
会 (huì) - Can/Know how to (skill) |  | - HSK Level 1
东西 (dōngxi) - Thing/Things |  | - HSK Level 1
大家 (dàjiā) - Everyone |  | - HSK Level 1
时间 (shíjiān) - Time |  | - HSK Level 1
现在 (xiànzài) - Now |  | - HSK Level 1
一点儿 (yìdiǎnr) - A little/A bit |  | - HSK Level 1
还 (hái) - Still/Yet |  | - HSK Level 1
再 (zài) - Again |  | - HSK Level 1
都 (dōu) - All/Both |  | - HSK Level 1
没有 (méiyǒu) - Don't have/There isn't |  | - HSK Level 1
多 (duō) - Many/Much |  | - HSK Level 1
少 (shǎo) - Few/Little |  | - HSK Level 1
一起 (yìqǐ) - Together - HSK Level 1
能 (néng) - Can/Be able to (capability/possibility) |  | - HSK Level 1
学习 (xuéxí) - Learn/Study |  | - HSK Level 1
喝 (hē) - Drink |  | - HSK Level 1
吃 (chī) - Eat |  | - HSK Level 1
住 (zhù) - Live/Stay |  | - HSK Level 1
打电话 (dǎ diànhuà) - Make a phone call |  | - HSK Level 1
做 (zuò) - Do/Make |  | - HSK Level 1
请 (qǐng) - Please/Invite |  | - HSK Level 1
谢谢 (xièxiè) - Thank you |  | - HSK Level 1
对不起 (duìbùqǐ) - Sorry |  | - HSK Level 1
知道 (zhīdào) - Know (a fact) |  | - HSK Level 1
买 (mǎi) - Buy |  | - HSK Level 1
卖 (mài) - Sell |  | - HSK Level 1
几 (jǐ) - How many (for numbers under 10) |  | - HSK Level 1
今天 (jīntiān) - Today |  | - HSK Level 1
明天 (míngtiān) - Tomorrow |  | - HSK Level 1
昨天 (zuótiān) - Yesterday |  | - HSK Level 1
大 (dà) - Big |  | - HSK Level 1
小 (xiǎo) - Small |  | - HSK Level 1
漂亮 (piàoliang) - Beautiful/Pretty |  | - HSK Level 1
好 (hǎo) - Good |  | - HSK Level 1
忙 (máng) - Busy |  | - HSK Level 1
时候 (shíhòu) - Time/Moment |  | - HSK Level 1
认识 (rènshì) - Know (a person)/Meet for the first time |  | - HSK Level 1
太...了 (tài...le) - Too/Extremely |  | - HSK Level 1
...的时候 (...de shíhòu) - When... |  | - HSK Level 1
从...到... (cóng...dào...) - From... to... |  | - HSK Level 1
跟...一样 (gēn... yíyàng) - The same as... |  | - HSK Level 1
比 (bǐ) - Compare/Than (used in comparisons) |  | - HSK Level 1
还是 (háishì) - Or (in questions) |  | - HSK Level 1
因为...所以... (yīnwèi... suǒyǐ...) - Because... Therefore/So... |  | - HSK Level 1
不但...而且... (bùdàn... érqiě...) - Not only... but also... |  | - HSK Level 1
虽然...但是... (suīrán... dànshì...) - Although/Though... But... |  | - HSK Level 1
如果...的话 (rúguǒ... dehuà) - If... |  | - HSK Level 1
不过 (búguò) - However/But |  | - HSK Level 1
除了...以外 (chúle... yǐwài) - Apart from.../Besides... |  | - HSK Level 1
又...又... (yòu... yòu...) - Both... and... |  | - HSK Level 1
都 (dōu) - All/Both  |  |- HSK Level 1
一边...一边... (yìbiān... yìbiān...) - Doing two actions simultaneously |  | - HSK Level 1
先...再... (xiān... zài...) - First... then... |  | - HSK Level 1
越...越... (yuè... yuè...) - The more... the more... |  | - HSK Level 1
完 (wán) - Finish (verb complement indicating completion) |  | - HSK Level 1
得 (de) - Structural particle indicating how an action is done (e.g., 说得好 - speak well) |  | - HSK Level 1
正在...呢 (zhèngzài... ne) - In the process of/Currently (action in progress) |  | - HSK Level 1