演技する|えんぎする|to act, to perform|  |  |  |
卒業する|そつぎょうする|to graduate from  |  |  |  |
説得する|せっとくする|to persuade  |  |  |  |
記録する|きろくする|to record, to write down  |  |  |  |
下降する|かこうする|to come down, to descent, to drop  |  |  |  |
交代する|こうたいする|to take turns, to take a person's place  |  |  |  |
許可する|きょかする|to permit  |  |  |  |
生活する|せいかつする|to make a living, to support oneself  |  |  |  |
感心する|かんしんする|to admire, to be impressed  |  |  |  |
旅行する|りょこうする|to travel  |  |  |  |
留学する|りゅうがくする|to study abroad  |  |  |  |
採用する|さいようする|to employ, to adopt (measures)  |  |  |  |
調査する|ちょうさする| to investigate, to inquire into, to examine|  |  |  |
修理する|しゅうりする|to repair, to mend, to fix  |  |  |  |
コントロールする|コントロールする|to control  |  |  |  |
勉強する|べんきょうする|to study, to give a discount|  |  |  |
指示する|しじする|to instruct  |  |  |  |
経営する|けいえいする|to manage, to conduct, to run (a business)  |  |  |  |
維持する|いじする| to maintain, to support, to keep |  |  |  |
キャンセルする|キャンセルする|to cancel  |  |  |  |
紹介する|しょうかいする|to introduce, to present  |  |  |  |
管理する|かんりする|to manage, to control, to administer  |  |  |  |
限定する|げんていする|to limit, to restrict|  |  |  |
逮捕する|たいほする|to arrest, to apprehend  |  |  |  |
完成する|かんせいする|to finish, to complete  |  |  |  |
否定する|ひていする| to deny, to negate |  |  |  |
準備する|じゅんびする|to prepare  |  |  |  |
面接する|めんせつする|to interview  |  |  |  |
想像する|そうぞうする|to imagine, to guess  |  |  |  |
案内する|あんないする|to guide, to lead|  |  |  |
証明する|しょうめいする|to prove, to testify, to certify  |  |  |  |
誤解する|ごかいする|to misunderstand|  |  |  |
主張する|しゅちょうする|to insist on, to assert, to emphasise  |  |  |  |
フォローする|フォローする|to follow online (IT term)|  |  |  |
録音する|ろくおんする|to record (sound)  |  |  |  |
爆発する|ばくはつする|to explode, to burst, to blow up|  |  |  |
統一する|とういつする|to unify, to unite  |  |  |  |
運営する|うんえいする|to manage, to run, to administer  |  |  |  |
納得する|なっとくする|to be convinced  |  |  |  |
緊張する|きんちょうする|to be tense, to be nervous  |  |  |  |
