上昇する|じょうしょうする|to go up, to rise, to ascend  |  |  |  |
失敗する|しっぱいする|to fail  |  |  |  |
入学する|にゅうがくする|to enter a school  |  |  |  |
妥協する|だきょうする|to compromise|  |  |  |
違反する|いはんする| to violate  |  |  |  |
反映する|はんえいする|to reflect|  |  |  |
営業する|えいぎょうする|to do business, to be open|  |  |  |
質問する|しつもんする|to ask a question  |  |  |  |
対立する|たいりつする|to be opposed  |  |  |  |
追加する|ついかする|to supplement, to add  |  |  |  |
要求する|ようきゅうする|to demand, to claim  |  |  |  |
カットする|カットする|to cut  |  |  |  |
アレンジする|アレンジする|to arrange|  |  |  |
発行する|はっこうする|to publish, to issue, to bring out|  |  |  |
ダウンロードする|ダウンロードする|to download (IT term)|  |  |  |
攻撃する|こうげきする|to attack, to charge, to criticize  |  |  |  |
誘拐する|ゆうかいする|to kidnap  |  |  |  |
約束する|やくそくする|to promise  |  |  |  |
見物する|けんぶつする|to go sightseeing  |  |  |  |
意図する|いとする|to intend to do, to make a goal  |  |  |  |
保証する|ほしょうする| to guarantee, to warrant |  |  |  |
応援する|おうえんする|to aid, to support, to encourage, to cheer  |  |  |  |
貯金する|ちょきんする| to save money|  |  |  |
相談する|そうだんする|to consult, to discuss  |  |  |  |
不足する|ふそくする|to be short of, to be lacking|  |  |  |
反省する|はんせいする| to reflect on oneself, to reconsider |  |  |  |
選択する|せんたくする|to choose, to select  |  |  |  |
弁護する|べんごする|to defend, to testify for|  |  |  |
セットする|セットする|to set  |  |  |  |
拒否する|きょひする|to refuse, to reject, to deny  |  |  |  |
減少する|げんしょうする|to decrease|  |  |  |
認識する|にんしきする|to recognize, to realize, to understand  |  |  |  |
予習する|よしゅうする|to study beforehand  |  |  |  |
練習する|れんしゅうする|to practice, to excercise  |  |  |  |
けんかする|けんかする|to quarrel, to fight  |  |  |  |
支配する|しはいする|to control, to dominate  |  |  |  |
愛用する|あいようする|to use regularly, to patronize|  |  |  |
推薦する|すいせんする|to recommend  |  |  |  |
ハグする|ハグする|to hug|  |  |  |
和解する|わかいする|to be reconciled with  |  |  |  |
復習する|ふくしゅうする|to review, to go over|  |  |  |
提出する|ていしゅつする|to submit, to present  |  |  |  |
援助する|えんじょする|to assist, to help, to support, to aid|  |  |  |
生産する|せいさんする|to produce, to manufacture  |  |  |  |
解放する|かいほうする|to release, to set a prisoner free  |  |  |  |
利用する|りようする|to make use of  |  |  |  |
担当する|たんとうする|to take charge of  |  |  |  |
輸入する|ゆにゅうする|to import  |  |  |  |
出張する|しゅっちょうする|to go on a business trip  |  |  |  |
理解する|りかいする|to understand, to comprehend  |  |  |  |
離婚する|りこんする|to divorce  |  |  |  |
