組織する|そしきする|to organize, to form  |  |  |  |
普及する|ふきゅうする|to spread, to diffuse|  |  |  |
信用する|しにょうする|to trust, to believe, to place confidence in  |  |  |  |
裁判する|さいばんする|to hold a trial  |  |  |  |
縮小する|しゅくしょうする|to reduce, to cut, to curtail  |  |  |  |
譲歩する|じょうほする|to concede, to give way to  |  |  |  |
考慮する|こうりょする|to consider, to think over  |  |  |  |
改正する|かいせいする|to revise, to amend, to improve  |  |  |  |
実験する|じっけんする|to experiment  |  |  |  |
絶望する|ぜつぼうする|to have no hope, to be in despair  |  |  |  |
所有する|しょゆうする|to own, to posess  |  |  |  |
集中する|しゅうちゅうする|to concentrate, to centralize  |  |  |  |
掃除する|そうじする|to clean  |  |  |  |
所属する|しょぞくする|to belong to  |  |  |  |
開放する|かいほうする|to open a place to the public  |  |  |  |
往復する|おうふくする|to go and return  |  |  |  |
研修する|けんしゅうする|to study, to train, to intern  |  |  |  |
応用する|おうようする|to apply, to put into practice  |  |  |  |
議論する|ぎろんする|to argue, to discuss, to debate|  |  |  |
努力する|どりょくする|to make an effort, to work hard|  |  |  |
影響する|えいきょうする|to influence, to affect|  |  |  |
弁償する|べんしょうする|to compensate, to repay for loss|  |  |  |
期待する|きたいする|to expect, to hope  |  |  |  |
補償する|ほしょうする| to compensate, to make up for |  |  |  |
上映する|じょうえいする|to show a film  |  |  |  |
迷惑する|めいわくする|to be troubled, to be annoyed  |  |  |  |
競争する|きょうそうする|to compete  |  |  |  |
実行する|じっこうする|to carry out, to execute  |  |  |  |
同意する|どういする|to agree, to approve|  |  |  |
キスする|キスする|to kiss  |  |  |  |
復活する|ふっかつする|to revive, to restore|  |  |  |
ファックスする|ファックスする|to fax|  |  |  |
節約する|せつやくする|to economize, to skimp, to save  |  |  |  |
救助する|きゅうじょする|to rescue, to help  |  |  |  |
強制する|きょうせいする|to compel, to force a person to do  |  |  |  |
遠慮する|えんりょする|to refrain, to hold back|  |  |  |
予防する|よぼうする|to prevent, to protect  |  |  |  |
解決する|かいけつする|to settle, to resolve  |  |  |  |
検討する|けんとうする|to examine, to investigate, to think over  |  |  |  |
消費する|しょうひする|to consume, to extend  |  |  |  |
廃止する|はいしする|to abolish, to do away with, to repeal|  |  |  |
出版する|しゅっぱんする|to publish, to issue  |  |  |  |
一致する|いっちする|to agree with, to be in unison  |  |  | PAGE 344 |
発展する|はってんする| to develop, to expand |  |  |  |
予約する|よやくする|to reserve, to book  |  |  |  |
運転する|うんてんする|to drive, to manage (money)  |  |  |  |
改革する|かいかくする|to reform, to improve  |  |  |  |
配達する|はいたつする|to deliver|  |  |  |
経過する|けいかする|to pass, total elapse, to expire  |  |  |  |
提案する|ていあんする|to propose, to suggest  |  |  |  |
浪費する|ろうひする|to waste (money or time), to throw away  |  |  |  |
